111111
100001
100101
100001
100E01
100001
100P01
11C101
111111
