111111
100001
10P101
100001
100E01
100001
100001
11C101
111111
