1111111111
1P00000C11
11C1000011
1000101C01
1C00101011
1000001001
10110000E1
1111111111
